gene	core
traD	core
traI	core
yaf	core
ltgX	soft core
yag	core
traA	core
traL	core
traE	core
traK	core
traB	core
dsbC	core
traV	core
traC	core
ybe	core
trbI	core
traW	core
traU	core
trbC	core
ybi	core
traN	core
ycb	core
traF	core
traH	core
traG	shell
atlA	shell
ych	shell
exp1	shell
cspA	soft core
exp2	cloud
yda	core
ydbA	core
ydbB	core
ydcA	core
ydcB	core
ydd	core
ydeA	core
ydeB	core
ydf	core
ydg	core
ydhA	core
ydhB	soft core
ydi	core
yea	core
yeb	core
yecA	core
yecB	core
yedA	core
yedB	core
yee	core
yegA	core
yegB	core
yeh	core
topB	core
ssbB	core
yfa	core
yfb	core
yfd	core
yfeA	core
yfeB	core
parB	core
parA	core